NO textures/north.xpm
SO textures/south.xpm
WE textures/west.xpm
EA textures/east.xpm
F 187,210,225
C 37,253,233

        1111111 11111111111111111111
        1100001 10000110000001000001
        1010001 10011100000010000011
        1001001 10000000000000000001
111111111111001 10001110000000000001
100000000011001 10001110100111111111
100000000000001 1000000000000001
100000000000001 1000000000000001
100000011000001 100000011000001
100000011000001 100000011000001
100000000000001 1000000000000001
100000000001001 1000000000000001
100000000000001 100000000000001
111101111101111 1011100000010001
111101111101111 1011101010010001
110000001101011 1011100000010001
100010000000001 10000000000N0001
100000000000001 1000001010000001
110000011101011 10111110111100111
11110111 111011 101 101111010001
11111111 111111 111 111111111111