NO textures/north.xpm
SO textures/south.xpm
WE textures/west.xpm
EA textures/east.xpm
F 187,210,225
C 37,253,233

        111111 1111111111111111111
        110000 0000110000001000001
        101000 0011100000010000011
        100100 0000000000000000001
11111111111100 0001110000000000001
10000000001100 0001110100111111111
10000000000000 000000000000001
10000000000000 000000000000001
10000001100000 00000011000001
10000001100000 00000011000001
10000000000000 000000000000001
10000000000100 000000000000001
10000000000000 00000000000001
11110111110111 011100000010001
11110111110111 011101010010001
11000000110101 011100000010001
10001000000001 N0000000000001
10000000000000 000001010000001
11000001110101 0111110111100111
11110111 11101 01 101111010001
11111111 11111 11 111111111111