NO textures/north.xpm
SO textures/south.xpm
WE textures/west.xpm
EA textures/east.xpm
F 187,210,225
C 37,253,233

         11111 111  111111 111111
        110001 100110000001000001
        101001 110100000010000011
        1001001000000000000001101  1
  111111111100000111000000001 101  11
 10000000011000001110100111111 11111
10000000000000000000000000001   1  11
10011000000000000000000000001      111
101  101100000222200011000001       1
111 100111000000000011000001
    10011 10000200000000000001
111  11   100000000001111111
101 111 1100000000001 1000001   1  1
111     1101110111001 1010001  101101
111111 11101110111011 1110001  100001
110001 11101010111001   1000111101101
10001010000000000000  11N00000000000011
 100000000000000000111000000111101110001
110000011101010111000001100111 100011101
1 110111 1110101 101111010001   1101  1
    1111 1111111 111111111111     1